{
    "version": 1.0,
    "name": "default Map",
    "numberOfExtraWall": 8,
    "wall": {
        "nummberOfMovingWall": 1
    },
    "minotaurus": {
        "activ": true,
        "deplacement": 8
    },
    "wallJump": {
        "deplacement": 1,
        "wallThickness": 1
    },
    "diceFace": [
        4,
        5,
        6,
        "minotaur",
        "wallJump",
        "wall"
    ],
    "data": [
        "████████████████████████████████",
        "█BB                          YY█",
        "█B                            Y█",
        "█   ▒▒  ▓   ▓▓▓  ▓▓▓   ▓  ▒▒   █",  
        "█       ▓   ▓      ▓   ▓       █",
        "█       ▓   ▓      ▓   ▓       █",
        "█  ▓▓  ▓▓▓  ▓▓▓  ▓▓▓  ▓▓▓  ▓▓  █",
        "█  ▓                        ▓  █",
        "█  ▓                        ▓  █",
        "█     ▓  ▒  ▓▓▓  ▓▓▓  ▒  ▓     █",
        "█     ▓  ▒  ▓      ▓  ▒  ▓     █",
        "█  ▓▓▓▓     ▓      ▓     ▓▓▓▓  █",
        "█  ▓        ▓  ▓▓  ▓        ▓  █",
        "█  ▓     ▓            ▓     ▓  █",
        "█  ▓   ▓▓▓    bbyy    ▓▓▓   ▓  █",
        "█           ▓ bMMy ▓           █",
        "█           ▓ bMMY ▓           █",
        "█  ▓   ▓▓▓    BBYY    ▓▓▓   ▓  █",
        "█  ▓     ▓            ▓     ▓  █",
        "█  ▓        ▓  ▓▓  ▓        ▓  █",
        "█  ▓▓▓▓     ▓      ▓     ▓▓▓▓  █",
        "█     ▓  ▒  ▓      ▓  ▒  ▓     █",
        "█     ▓  ▒  ▓▓▓  ▓▓▓  ▒  ▓     █",
        "█  ▓                        ▓  █",
        "█  ▓                        ▓  █",
        "█  ▓▓  ▓▓▓  ▓▓▓  ▓▓▓  ▓▓▓  ▓▓  █",
        "█       ▓   ▓      ▓   ▓       █",
        "█       ▓   ▓      ▓   ▓       █",
        "█   ▒▒  ▓   ▓▓▓  ▓▓▓   ▓  ▒▒   █",
        "█B                            Y█",
        "█BB                          YY█",
        "████████████████████████████████"
    ]
}